BOF
2023-05-01 10:22:56.304674
850
SWatson|Watson|Sara||||Designer, furniture|||||nfox@example.com
PSmith|Smith|Patricia||||Glass blower/designer|||||mphillips@example.com
JCantu|Cantu|Jeffrey||||Forensic psychologist|||||smiththomas@example.com
JWatson|Watson|Joshua||||Industrial buyer|||||ygonzalez@example.net
KButler|Butler|Kelly||||Tourism officer|||||thomaskristina@example.net
CPerry|Perry|Carol||||Politician's assistant|||||osnyder@example.org
KWard|Ward|Kristen||||Sports therapist|||||cynthiaadams@example.org
MMoore|Moore|Melissa||||Trade mark attorney|||||walshjohnny@example.net
JDiaz|Diaz|Jacob||||Runner, broadcasting/film/video|||||wilsondavid@example.com
JRussell|Russell|Jon||||Economist|||||ramosdonna@example.org
SHicks|Hicks|Shannon||||Education officer, environmental|||||riosbrittany@example.com
WJohnson|Johnson|William||||Homeopath|||||mark97@example.com
ERoberson|Roberson|Emma||||Programmer, multimedia|||||rdouglas@example.com
SRamsey|Ramsey|Susan||||Art therapist|||||ghill@example.net
MMartinez|Martinez|Micheal||||Archaeologist|||||melissa14@example.org
GWright|Wright|George||||Intelligence analyst|||||iramos@example.net
MEvans|Evans|Matthew||||Psychologist, forensic|||||andrewanderson@example.net
JRice|Rice|John||||Field seismologist|||||yosborne@example.com
KTorres|Torres|Kevin||||Producer, radio|||||carolbass@example.org
CGray|Gray|Craig||||Librarian, public|||||khicks@example.com
NJimenez|Jimenez|Nicholas||||Secretary, company|||||vnavarro@example.com
PMcconnell|Mcconnell|Patricia||||Designer, fashion/clothing|||||williamsmargaret@example.net
MFischer|Fischer|Maria||||Astronomer|||||qlawson@example.net
JHuffman|Huffman|Jasmin||||Oncologist|||||williamphillips@example.org
CHill|Hill|Charles||||Private music teacher|||||zhodges@example.org
RDixon|Dixon|Randy||||Medical technical officer|||||diana61@example.org
GWilliams|Williams|Gregory||||Statistician|||||newmanphillip@example.org
CJohnson|Johnson|Cory||||Civil Service fast streamer|||||lmorgan@example.net
BGraves|Graves|Beth||||Administrator, charities/voluntary organisations|||||bartonmartha@example.net
PLee|Lee|Paul||||Theme park manager|||||delgadotiffany@example.net
AWright|Wright|Amy||||Designer, exhibition/display|||||fstanley@example.org
LLam|Lam|Lawrence||||Surveyor, land/geomatics|||||heverett@example.net
CCuevas|Cuevas|Cynthia||||Designer, blown glass/stained glass|||||greenejoyce@example.net
PHernandez|Hernandez|Peter||||Brewing technologist|||||werickson@example.net
BThomas|Thomas|Beth||||Social worker|||||patricia05@example.org
JFitzgerald|Fitzgerald|Jacob||||Industrial/product designer|||||khull@example.com
DMatthews|Matthews|Donna||||Warden/ranger|||||chelseajones@example.org
TSpencer|Spencer|Thomas||||Museum/gallery conservator|||||uerickson@example.net
KMichael|Michael|Krista||||Librarian, public|||||georgegutierrez@example.net
CWaters|Waters|Clarence||||Maintenance engineer|||||robert96@example.org
SRodriguez|Rodriguez|Samantha||||Farm manager|||||katie23@example.org
KMason|Mason|Kevin||||Insurance risk surveyor|||||johnnyarias@example.com
JHernandez|Hernandez|Julia||||Development worker, community|||||matthew64@example.com
SHaas|Haas|Savannah||||Conservation officer, nature|||||vsmith@example.net
PFord|Ford|Peter||||Barista|||||omartinez@example.com
DPerry|Perry|Derrick||||Pension scheme manager|||||eric11@example.org
JHines|Hines|Jessica||||Clinical psychologist|||||zmcguire@example.net
SJohnson|Johnson|Stephen||||Water engineer|||||morgan67@example.com
CHudson|Hudson|Charles||||Television production assistant|||||sarahcochran@example.com
JMartin|Martin|Justin||||Accountant, chartered|||||haynesmichael@example.com
KGriffith|Griffith|Kayla||||Nurse, children's|||||josephcase@example.com
WStevens|Stevens|Willie||||Cabin crew|||||jesus58@example.net
AMoon|Moon|Amanda||||Scientist, biomedical|||||millerjennifer@example.net
KLi|Li|Kylie||||Biomedical scientist|||||jenniferwatson@example.org
TVaughan|Vaughan|Todd||||Psychiatric nurse|||||umoore@example.com
EMiddleton|Middleton|Emily||||Development worker, international aid|||||drakejulie@example.net
RSawyer|Sawyer|Rachel||||Operational investment banker|||||robert95@example.org
VDawson|Dawson|Vincent||||Warehouse manager|||||vdunn@example.com
CRusso|Russo|Chelsea||||Theatre manager|||||dwaynebrooks@example.net
WBarber|Barber|William||||Brewing technologist|||||darrenfarmer@example.com
NCruz|Cruz|Nicholas||||Industrial buyer|||||nboyle@example.net
DJones|Jones|Denise||||Theatre manager|||||huertaandrew@example.com
CNichols|Nichols|Christopher||||Education officer, museum|||||theresa60@example.org
DHunter|Hunter|Dennis||||Conservation officer, nature|||||teresaperkins@example.org
SChambers|Chambers|Stephanie||||IT trainer|||||satkins@example.com
AWaters|Waters|Allen||||Chartered legal executive (England and Wales)|||||ritterkimberly@example.com
JRichardson|Richardson|Jonathan||||Bonds trader|||||bellethan@example.org
CSmith|Smith|Cindy||||Therapist, occupational|||||perryyvonne@example.net
NMason|Mason|Nicholas||||Chemist, analytical|||||richard96@example.org
KJones|Jones|Kari||||Gaffer|||||gracewilliams@example.org
CMiller|Miller|Cameron||||Accountant, chartered|||||jessica83@example.org
DMorris|Morris|Daniel||||Pensions consultant|||||jchapman@example.com
JFox|Fox|James||||Designer, multimedia|||||bmoss@example.net
RWang|Wang|Rebecca||||Exhibitions officer, museum/gallery|||||elizabeththomas@example.net
GYoung|Young|Gary||||Minerals surveyor|||||christineanderson@example.net
KWilcox|Wilcox|Kimberly||||Research scientist (life sciences)|||||karismith@example.com
JGoodman|Goodman|Julia||||Child psychotherapist|||||katherine07@example.com
AChase|Chase|Anna||||IT technical support officer|||||edixon@example.net
DCooper|Cooper|David||||Clinical scientist, histocompatibility and immunogenetics|||||williamsvictoria@example.org
PEsparza|Esparza|Phyllis||||Surveyor, hydrographic|||||stephenmason@example.net
EBishop|Bishop|Elizabeth||||Geophysicist/field seismologist|||||ryanblevins@example.org
IJohnson|Johnson|Isabel||||Illustrator|||||ddavis@example.net
MLara|Lara|Michael||||Land/geomatics surveyor|||||qpatterson@example.com
MGray|Gray|Megan||||Nutritional therapist|||||ghoward@example.com
TSmith|Smith|Tiffany||||Ophthalmologist|||||fmoore@example.org
ALopez|Lopez|Andrea||||Aid worker|||||zgilbert@example.org
MWood|Wood|Michael||||Administrator, charities/voluntary organisations|||||ashleykaren@example.net
JSolomon|Solomon|Jody||||Site engineer|||||jcooper@example.org
RLopez|Lopez|Robert||||Engineer, electrical|||||agordon@example.com
GEspinoza|Espinoza|Gina||||Designer, blown glass/stained glass|||||norrismary@example.net
CMatthews|Matthews|Christopher||||Ship broker|||||clarkjoseph@example.org
JSingleton|Singleton|Joanna||||Animator|||||nicolegeorge@example.org
JFlowers|Flowers|Jacob||||Toxicologist|||||sandra40@example.net
KDavis|Davis|Keith||||Designer, furniture|||||brownbrian@example.com
CSmith|Smith|Casey||||Quality manager|||||katherine32@example.com
KGlenn|Glenn|Katie||||Public relations account executive|||||fuentespatricia@example.org
HBrown|Brown|Holly||||Historic buildings inspector/conservation officer|||||diazmary@example.org
BRay|Ray|Brianna||||Electronics engineer|||||richard70@example.net
SHoffman|Hoffman|Shannon||||Technical author|||||garciarodney@example.com
NSmith|Smith|Nicholas||||Catering manager|||||elogan@example.org
